1111111111111111111111111111111111111111111111
1100000000000000000000000000000000000000000001
1100111111111111111111111111000000000000000001
1000000000000000000000100000000000011100000001
1000000000000000000000000000000000000000000001
1000000000010010000000000000000000000000000001
10000000001C00PE0000001000M0000000000000000001
1000000000010010000000010001111000000000000001
1000000000000000000000000010000000000000000001
10000000000111111100000100M0000011110000000001
1000000000000000000000000000000000000000000001
1000000000000000000000000000000000000000000001
1000000000000000000000000000000111111100000011
1111111111111111111111111111111111111111111111